15 15
4 4 4 4 4 4 4 4 4 4 4 4 4 4 4
4 4 7 4 4 0 0 0 4 4 4 4 4 4 4
4 4 5 4 4 0 0 0 4 4 4 4 4 4 4
4 4 5 4 4 4 5 4 4 4 4 8 4 4 4
4 4 5 4 4 4 5 4 4 4 4 5 4 4 4
4 4 5 4 4 4 5 4 4 4 4 5 4 4 4
4 4 5 4 4 4 5 4 4 2 2 1 4 4 4
4 4 5 5 5 5 5 5 5 5 2 5 4 4 4
4 4 4 4 0 0 0 4 4 5 2 5 4 4 4
4 4 4 4 0 0 0 4 4 5 4 5 4 4 4
4 8 5 1 0 0 0 4 4 5 5 5 4 4 4
4 4 4 4 0 0 0 4 4 4 4 4 4 4 4
4 4 4 4 4 4 5 4 4 4 4 4 4 4 4
4 4 4 4 5 5 5 5 5 5 5 5 7 4 4
4 4 4 4 4 4 4 4 4 4 4 4 4 4 4